#########################################
#S#       #                # # #    # # #
# # # ### # ######## ##### # # # ## #   #
# # # # # # #      # # # # #   # #  ## ##
# ### # #   # ####   #   # # # # # #    #
#     # # # # # ## # ### # # # # # #### #
# ### # # #####    # #   # # # # #      #
# # # #   #     #### # ### # # # # ######
# # # # # # ### #    #   #   # #F#      #
#   # # # # # # # ###### # # # ######## #
### # # # # # # # # ## # # # #     #  # #
# # # # # ### #   #      # # # # # ## # #
# # # # # #   # # #####    # # ### ## # #
# ### # ### ### #       ## ##### # ## # #
#     #         ##########     #        #
#########################################